SO ./textures/south.xpm

NO ./textures/south.xpm

WE ./textures/south.xpm

EA ./textures/south.xpm

F 100, 100, 100

C 200, 200, 200

111111111
100001001
100010001
100W01001
100000001
100010001
100010001
100010001
100111001
100000001
100000001
111111111
