NO textures/wolfenstein/grey_stone.xpm
SO textures/wolfenstein/purple_stone.xpm
WE textures/wolfenstein/red_brick.xpm
EA textures/wolfenstein/wood.xpm

F 220,100,0
C 225,30,0

        11111111          1111111
        1000000111  111111 01
        1011000001110000000001111
        1001000000000000000000001
111 11111011000001110000000000001
101 10000011000001110111111111111
11110111111111011100000010001
11100111111111011101010010001
1100         1011100000010001
10000000000000001100000010001
1000000000000000110101001000111111111111
11000001110101011111011110N0000000000001
11110111 1110101 10111101000111111111111
11111111 1111111 111111111111
