







NO textures/test/south.xpm








SO textures/test/north.xpm
                        WE textures/matrix.xpm
        EA textures/test/west.xpm

        F 20,           20,             20

11111
10001
10S01
10001
10001
10001
10011
10001
10001
10001
10001
10001
11111


C 200,          200,200





















